+---+---+-----+---+-------+-----+
    |   |     |   |       |     |
| --+ | | | | | | | +-+ --+ +-- |
|     |   | |   | | | |     |   |
| +---+---+ +-+-+ | | +-----+ | |
| |       |   |   |   |     | | |
| +---- +-+-- | +-+ +-+ +-- | | |
|       |     | | | |   |   | | |
+---- +-+ +---+ | | | +-+ +-+ | |
|     |   |     |   | |   |   | |
| +---+ +-+ +---+-+ | +-+ +-+ +-+
| |   | | | |     | |   |   |   |
| +-- | | | | | | +-+ | +-+ +-+ |
| |   | |   | | |   | |   |   | |
| | --+ | --+-+ +-- +-+-- +-- | |
| |     |       |         |      
+-+-----+-------+---------+-----+